    changePokemonButton: "Échange de Pokemon",
    searchBattle: "Recherche de combat",

    wantToBattle: "Est-ce que vous voulez commencer le combat ?",
    waitForPlayer: "Attente d'autres joueurs...",

    noTeam: "Tu n'as pas d'équipe.",
    TeamFainted: "Echec de la recherche. Tous tes Pokémons sont K.O.",

    // battle
    battlePlayerNotAccepted: "Ton adversaire a perdu la connexion avant que le combat ne commence.<br><br> Veuillez réessayer.",
    battleCancelled: "Le combat a été annulé.",
    battleAlreadyEnded: "Le combat est déjà terminé.",
    battleWaitForPlayer: "Attente d'autres joueurs...",
    battleMoveUsed: (pokemonName, moveName) => `<span class="battle-log-pokemonname" style="color:#63ff78">${pokemonName}</span> utilise <span class="battle-log-movename" style="color:#ff6374">${moveName}</span>.`,
    battleMoveFailed: "Cela a échoué...",
    battleAttackMissed: (pokemonName) => `L'attaque de <span class="battle-log-pokemonname" style="color:#63ff78">${pokemonName}</span> a raté.`,
    battleNotEffective: "Ce n'est pas très efficace...",
    battleEffective: "C'est super efficace !",
    battleNoEffect: "Cela n'a pas d'effet...",
    battleCriticalHit: "Coup critique !",
    battleNotAwaitingMove: "Capacité déjà sélectionnée.",
    battleMultipleHits: (amount) => `${amount} coups !`,
    battleStatUp1: (pokemonName, statName) => `La statistique ${statName} de <span class="battle-log-pokemonname" style="color:#63ff78">${pokemonName}</span> a augmenté.`,
    battleStatUp2: (pokemonName, statName) => `La statistique ${statName} de <span class="battle-log-pokemonname" style="color:#63ff78">${pokemonName}</span> a fortement augmenté !`,
    battleStatUp3: (pokemonName, statName) => `La statistique ${statName} de <span class="battle-log-pokemonname" style="color:#63ff78">${pokemonName}</span> a très fortement augmenté !`,
    battleStatDown1: (pokemonName, statName) => `La statistique ${statName} de <span class="battle-log-pokemonname" style="color:#63ff78">${pokemonName}</span> a diminué.`,
    battleStatDown2: (pokemonName, statName) => `La statistique ${statName} de <span class="battle-log-pokemonname" style="color:#63ff78">${pokemonName}</span> a fortement diminué !`,
    battleStatDown3: (pokemonName, statName) => `La statistique ${statName} de <span class="battle-log-pokemonname" style="color:#63ff78">${pokemonName}</span> a très fortement diminué !`,

    // status effects
    battleEnemySleeping: (pokemonName) => `<span class="battle-log-pokemonname" style="color:#63ff78">${pokemonName}</span> s'est endormi.`,
    battleEnemyParalysis: (pokemonName) => `<span class="battle-log-pokemonname" style="color:#63ff78">${pokemonName}</span> est paralysé.`,
    battleEnemyPoison: (pokemonName) => `<span class="battle-log-pokemonname" style="color:#63ff78">${pokemonName}</span> est empoisonné.`,
    battleEnemyToxic: (pokemonName) => `<span class="battle-log-pokemonname" style="color:#63ff78">${pokemonName}</span> est gravement empoisonné.`,
    battleEnemyBurned: (pokemonName) => `<span class="battle-log-pokemonname" style="color:#63ff78">${pokemonName}</span> est brulé.`,
    battleIsParalyzed: (pokemonName) => `<span class="battle-log-pokemonname" style="color:#63ff78">${pokemonName}</span> est paralysé.`,
    battleEnemyConfused: (pokemonName) => `<span class="battle-log-pokemonname" style="color:#63ff78">${pokemonName}</span> est confus.`,
    battleEnemyEndConfusion: (pokemonName) => `<span class="battle-log-pokemonname" style="color:#63ff78">${pokemonName}</span> n'est plus confus.`,
    battleEnemyFrozen: (pokemonName) => `<span class="battle-log-pokemonname" style="color:#63ff78">${pokemonName}</span> est gelé`,
    battleIsSleeping: (pokemonName) => `<span class="battle-log-pokemonname" style="color:#63ff78">${pokemonName}</span> est endormi et ne peut plus bouger.`,
    battleConfused: (pokemonName) => `<span class="battle-log-pokemonname" style="color:#63ff78">${pokemonName}</span> est confus et s'est blessé lui-même.`,
    battleIsFrozen: (pokemonName) => `<span class="battle-log-pokemonname" style="color:#63ff78">${pokemonName}</span> est gelé et ne peut plus bouger.`,
    battleFlinched: (pokemonName) => `<span class="battle-log-pokemonname" style="color:#63ff78">${pokemonName}</span> est apeuré et ne peut plus attaquer.`,
    battleHealed: (pokemonName) => `<span class="battle-log-pokemonname" style="color:#63ff78">HP of ${pokemonName}</span> ont été restaurés.`,
    battleWokeUp: (pokemonName) => `<span class="battle-log-pokemonname" style="color:#63ff78">${pokemonName}</span> s'est réveillé.`,
    battleUnthawed: (pokemonName) => `<span class="battle-log-pokemonname" style="color:#63ff78">${pokemonName}</span> est dégelé.`,
    battleRecoilApplied: (pokemonName) => `<span class="battle-log-pokemonname" style="color:#63ff78">${pokemonName}</span> a pris des dégats de recul.`,
    battlePoisonDamage: (pokemonName) => `<span class="battle-log-pokemonname" style="color:#63ff78">${pokemonName}</span> a pris des dégats de poison.`,
    battleBurnDamage: (pokemonName) => `<span class="battle-log-pokemonname" style="color:#63ff78">${pokemonName}</span> a pris des dégats de brûlure.`,
    battlePokemonChanged: (LastPokemonName, CurrentPokemonName) => `<span class="battle-log-pokemonname" style="color:#63ff78">${LastPokemonName}</span> a été échangé avec <span class="battle-log-pokemonname" style="color:#63ff78">${CurrentPokemonName}</span>.`,

    // field effects
    battleRainEnd: `Il s'est arrêté de pleuvoir`,
    battleRainStarted: `Il commence à pleuvoir`,
    battleHailStarted: `Il commence à grêler`,
    battleHailDamage: 'Le Pokémon prend des dégats de grêle.',
    battleHailEnd: 'Il s'est arrêté de grêler.',
    battleSandstormStarted: "Une tempête de sable se prépare",
    battleSandstormDamage: "Le Pokémon prend des dégats de la tempête de sable.",
    battleSandstormEnd: "La tempête de sable se calme.",
    battleSunStarted: `Les rayons du soleil brillent.`,
    battleSunEnd: `Le soleil se retire.`,

    // battle ended
    BattleWin: "Félicitations, tu as remporté le combat !",
    BattleLose: "Tu as perdu le combat !",
    BattleXP: (XP) => `Ton équipe remporte ${XP} EXP !`,
    BattleNoXP: "Ton équipe n'a pas remporté d'EXP !",
