    changePokemonButton: "Zmień Pokémon'a",
    searchBattle: "Wyszukaj Walkę",

    wantToBattle: "Chcesz rozpocząć walkę?",
    waitForPlayer: "Oczekiwanie na drugiego gracza...",

    noTeam: "Nie posiadasz drużyny.",
    TeamFainted: "Wyszukiwanie nie powiodło się. Wszystkie twoje Pokémony zemdlały",

    // battle
    battlePlayerNotAccepted: "Twój przeciwnik stracił połączenie przed rozpoczęciem walki.<br><br>Spróbuj ponownie.",
    battleCancelled: "Walka zostala anulowana.",
    battleAlreadyEnded: "Walka już się zakończyła.",
    battleWaitForPlayer: "Oczekiwanie na drugiego gracza...",
    battleMoveUsed: (pokemonName, moveName) => `<span class="battle-log-pokemonname" style="color:#63ff78">${pokemonName}</span> używa <span class="battle-log-movename" style="color:#ff6374">${moveName}</span>.`,
    battleMoveFailed: "Nie powiodło się...",
    battleAttackMissed: (pokemonName) => `Atak <span class="battle-log-pokemonname" style="color:#63ff78">${pokemonName}</span> nie trafił.`,
    battleNotEffective: "To nie jest zbyt skuteczne...",
    battleEffective: "To był bardzo skuteczny!",
    battleNoEffect: "To nie ma żadnego skutku...",
    battleCriticalHit: "Uderzenie krytyczne!",
    battleNotAwaitingMove: "Ruch został już wybrany.",
    battleMultipleHits: (amount) => `${amount} udeżeń!`,
    battleStatUp1: (pokemonName, statName) => `<span class="battle-log-pokemonname" style="color:#63ff78">${pokemonName}</span> ${statName} wzrosło.`,
    battleStatUp2: (pokemonName, statName) => `<span class="battle-log-pokemonname" style="color:#63ff78">${pokemonName}</span> ${statName} bardzo wzrosło!`,
    battleStatUp3: (pokemonName, statName) => `<span class="battle-log-pokemonname" style="color:#63ff78">${pokemonName}</span> ${statName} wzrosło drastycznie!`,
    battleStatDown1: (pokemonName, statName) => `<span class="battle-log-pokemonname" style="color:#63ff78">${pokemonName}</span> ${statName} spadło.`,
    battleStatDown2: (pokemonName, statName) => `<span class="battle-log-pokemonname" style="color:#63ff78">${pokemonName}</span> ${statName} gwałtownie spadło!`,
    battleStatDown3: (pokemonName, statName) => `<span class="battle-log-pokemonname" style="color:#63ff78">${pokemonName}</span> ${statName} poważnie spadło!`,

    // status effects
    battleEnemySleeping: (pokemonName) => `<span class="battle-log-pokemonname" style="color:#63ff78">${pokemonName}</span> zasnął.`,
    battleEnemyParalysis: (pokemonName) => `<span class="battle-log-pokemonname" style="color:#63ff78">${pokemonName}</span> został sparaliżowany.`,
    battleEnemyPoison: (pokemonName) => `<span class="battle-log-pokemonname" style="color:#63ff78">${pokemonName}</span> został otruty.`,
    battleEnemyToxic: (pokemonName) => `<span class="battle-log-pokemonname" style="color:#63ff78">${pokemonName}</span> został poważnie zatruty.`,
    battleEnemyBurned: (pokemonName) => `<span class="battle-log-pokemonname" style="color:#63ff78">${pokemonName}</span> został spalony.`,
    battleIsParalyzed: (pokemonName) => `<span class="battle-log-pokemonname" style="color:#63ff78">${pokemonName}</span> jest sparaliżowany i nie może się ruszyć.`,
    battleEnemyConfused: (pokemonName) => `<span class="battle-log-pokemonname" style="color:#63ff78">${pokemonName}</span> był zdezorientoway`,
    battleEnemyEndConfusion: (pokemonName) => `<span class="battle-log-pokemonname" style="color:#63ff78">${pokemonName}</span> otrząsnął się`,
    battleEnemyFrozen: (pokemonName) => `<span class="battle-log-pokemonname" style="color:#63ff78">${pokemonName}</span> został zamrożony`,
    battleIsSleeping: (pokemonName) => `<span class="battle-log-pokemonname" style="color:#63ff78">${pokemonName}</span> śpi i nie może się ruszyć.`,
    battleConfused: (pokemonName) => `<span class="battle-log-pokemonname" style="color:#63ff78">${pokemonName}</span> jest zdezorientowany i rani sam siebie.`,
    battleIsFrozen: (pokemonName) => `<span class="battle-log-pokemonname" style="color:#63ff78">${pokemonName}</span> jest zamrożony i nie może się ruszyć`,
    battleFlinched: (pokemonName) => `<span class="battle-log-pokemonname" style="color:#63ff78">${pokemonName}</span> stchórzył i nie mógł zaatakować`,
    battleHealed: (pokemonName) => `<span class="battle-log-pokemonname" style="color:#63ff78">HP of ${pokemonName}</span> odświeżył się.`,
    battleWokeUp: (pokemonName) => `<span class="battle-log-pokemonname" style="color:#63ff78">${pokemonName}</span> obudził się.`,
    battleUnthawed: (pokemonName) => `<span class="battle-log-pokemonname" style="color:#63ff78">${pokemonName}</span> rozmroził się.`,
    battleRecoilApplied: (pokemonName) => `<span class="battle-log-pokemonname" style="color:#63ff78">${pokemonName}</span> otrzymał obrażenia odrzutu.`,
    battlePoisonDamage: (pokemonName) => `<span class="battle-log-pokemonname" style="color:#63ff78">${pokemonName}</span> otrzymał obrażenia od trucizny.`,
    battleBurnDamage: (pokemonName) => `<span class="battle-log-pokemonname" style="color:#63ff78">${pokemonName}</span> otrzymał obrażenia od opażeń.`,
    battlePokemonChanged: (LastPokemonName, CurrentPokemonName) => `<span class="battle-log-pokemonname" style="color:#63ff78">${LastPokemonName}</span> zamienił się z <span class="battle-log-pokemonname" style="color:#63ff78">${CurrentPokemonName}</span>.`,

    // field effects
    battleRainEnd: `Przestało padać`,
    battleRainStarted: `Zaczęło padać`,
    battleHailStarted: `It started hailing`,
    battleHailDamage: 'Pokémon took hail damage.',
    battleHailEnd: 'The hail stopped.',
    battleSandstormStarted: "Rozpoczęła się burza piaskowa",
    battleSandstormDamage: "Pokémon otrzymał obrażenia od burzy piaskowej.",
    battleSandstormEnd: "Burza piaskowa ustała.",
    battleSunStarted: `Słońce świeci jasno.`,
    battleSunEnd: `Słońce zaszło.`,

    // battle ended
    BattleWin: "Gratujacje, Wygrałeś bitwę!",
    BattleLose: "Przegrałeś bitwę!",
    BattleXP: (XP) => `Twoja drużyna otrzymała ${XP} XP!`,
    BattleNoXP: "Twoja drużyna nie otrzymałą XP!",
};
