changePokemonButton: "Cambia Pokémon",
surrenderButton: "Arrenditi",
wantToSurrender: "Vuoi arrenderti? (Arrendersi troppe volte può portare a un timeout!)",
wantToSurrenderPrivate: "Vuoi arrenderti?",
searchBattle: "Cerca Battaglia",
searchBattleRanked: "Classificata",
searchBattleCasual: "Amichevole",
searchTourneyBattle: (Enemy) => `Torneo vs ${Enemy}`,
searchTourneyBattleNotReady: "Battaglia Torneo non pronta!",
searchBattleNotEnoguh: "Hai bisogno di 6 Pokémon nella tua squadra per le battaglie pubbliche!",

wantToBattlePrivate: "Inserisci la stessa password del tuo avversario per iniziare una battaglia privata.",
wantToBattleRanked: "Vuoi iniziare una battaglia classificata?",
rankedRequirements: "- Solo un pokemon con più di 567 di totale statistiche base",
waitForPlayer: "In attesa dell'altro giocatore...",

noTeam: "Non hai una squadra.",
TeamFainted: "Ricerca fallita. Uno o più dei tuoi Pokémon sono K.O.",
bannedPokemonInTeam: "Ricerca fallita. Uno o più dei tuoi Pokémon sono banditi dalla coda delle battaglie pubbliche",
notEnoughPokemon: "Ricerca fallita. Hai bisogno di almeno 6 Pokémon!",
userBanned: "Sei stato bandito per:",
removeFromTeam: "Rimuovi dalla squadra",
info: "Info",

// battle
battlePlayerNotAccepted: "Il tuo avversario si è disconnesso prima che la battagli iniziasse.<br><br>Per favore riprova.",
battleCancelled: "La battaglia è stata annullata.",
battleAlreadyEnded: "La battaglia si è già conclusa.",
battleWaitForPlayer: "Attendi l'altro giocatore...",
battleMoveUsed: (pokemonName, moveName) => `<span class="battle-log-pokemonname" style="color:#63ff78">${pokemonName}</span> usa <span class="battle-log-movename" 					style="color:#ff6374">${moveName}</span>.`,
battleMoveFailed: "Ma fallisce...",
battleAttackMissed: (pokemonName) => `<span class="battle-log-pokemonname" style="color:#63ff78">${pokemonName}</span> non colpisce l'avversario.`,
battleNotEffective: "Non è molto efficace...",
battleEffective: "E' super efficace!",
battleNoEffect: "Non ha effetto...",
battleCriticalHit: "Brutto colpo!",
battleNotAwaitingMove: "Hai già scelto la mossa.",
battleMultipleHits: (amount) => `Colpisce ${amount} volte!`,
battleStatUp1: (pokemonName, statName) => `La statistica ${statName} di <span class="battle-log-pokemonname" style="color:#63ff78">${pokemonName}</span> è aumentata.`,
battleStatUp2: (pokemonName, statName) => `La statistica ${statName} di <span class="battle-log-pokemonname" style="color:#63ff78">${pokemonName}</span> è aumentata di molto!`,
battleStatUp3: (pokemonName, statName) => `La statistica ${statName} di <span class="battle-log-pokemonname" style="color:#63ff78">${pokemonName}</span> è aumentata moltissimo!`,
battleStatDown1: (pokemonName, statName) => `La statistica ${statName} di <span class="battle-log-pokemonname" style="color:#63ff78">${pokemonName}</span> è diminuita.`,
battleStatDown2: (pokemonName, statName) => `La statistica ${statName} di <span class="battle-log-pokemonname" style="color:#63ff78">${pokemonName}</span> è diminuita di molto!`,
battleStatDown3: (pokemonName, statName) => `La statistica ${statName} di <span class="battle-log-pokemonname" style="color:#63ff78">${pokemonName}</span> è diminuita moltissimo!`,

// status effects
battleEnemySleeping: (pokemonName) => `<span class="battle-log-pokemonname" style="color:#63ff78">${pokemonName}</span> si addormenta.`,
battleEnemyParalysis: (pokemonName) => `<span class="battle-log-pokemonname" style="color:#63ff78">${pokemonName}</span> è stato paralizzato.`,
battleEnemyPoison: (pokemonName) => `<span class="battle-log-pokemonname" style="color:#63ff78">${pokemonName}</span> è stato avvelenato.`,
battleEnemyToxic: (pokemonName) => `<span class="battle-log-pokemonname" style="color:#63ff78">${pokemonName}</span> è stato iperavvelenato.`,
battleEnemyBurned: (pokemonName) => `<span class="battle-log-pokemonname" style="color:#63ff78">${pokemonName}</span> è stato scottato.`,
battleIsParalyzed: (pokemonName) => `<span class="battle-log-pokemonname" style="color:#63ff78">${pokemonName}</span> è paralizzato e non può muoversi.`,
battleEnemyConfused: (pokemonName) => `<span class="battle-log-pokemonname" style="color:#63ff78">${pokemonName}</span> è stato confuso`,
battleEnemyEndConfusion: (pokemonName) => `<span class="battle-log-pokemonname" style="color:#63ff78">${pokemonName}</span> non è più confuso`,
battleEnemyEndBurn: (pokemonName) => `<span class="battle-log-pokemonname" style="color:#63ff78">${pokemonName}</span> non è più bruciato`,
battleEnemyEndParalysis: (pokemonName) => `<span class="battle-log-pokemonname" style="color:#63ff78">${pokemonName}</span> non è più paralizzato`,
battleEnemyEndPoison: (pokemonName) => `<span class="battle-log-pokemonname" style="color:#63ff78">${pokemonName}</span> non è più avvelenato`,
battleEnemyFrozen: (pokemonName) => `<span class="battle-log-pokemonname" style="color:#63ff78">${pokemonName}</span> è stato congelato`,
battleIsSleeping: (pokemonName) => `<span class="battle-log-pokemonname" style="color:#63ff78">${pokemonName}</span> sta dormendo.`,
battleConfused: (pokemonName) => `<span class="battle-log-pokemonname" style="color:#63ff78">${pokemonName}</span> è così confuso da colpirsi da solo.`,
battleIsFrozen: (pokemonName) => `<span class="battle-log-pokemonname" style="color:#63ff78">${pokemonName}</span> è congelato`,
battleFlinched: (pokemonName) => `<span class="battle-log-pokemonname" style="color:#63ff78">${pokemonName}</span> tentenna`,
battleHealed: (pokemonName) => `<span class="battle-log-pokemonname" style="color:#63ff78"> i PV di ${pokemonName}</span> sono stati ripristinati.`,
battleWokeUp: (pokemonName) => `<span class="battle-log-pokemonname" style="color:#63ff78">${pokemonName}</span> si è svegliato.`,
battleUnthawed: (pokemonName) => `<span class="battle-log-pokemonname" style="color:#63ff78">${pokemonName}</span> si è scongelato.`,
battleRecoilApplied: (pokemonName) => `<span class="battle-log-pokemonname" style="color:#63ff78">${pokemonName}</span> subisce il contraccolpo.`,
battlePoisonDamage: (pokemonName) => `<span class="battle-log-pokemonname" style="color:#63ff78">${pokemonName}</span> soffre per l'avvelenamento.`,
battleBurnDamage: (pokemonName) => `<span class="battle-log-pokemonname" style="color:#63ff78">${pokemonName}</span> soffre per la scottatura.`,
battlePokemonChanged: (LastPokemonName, CurrentPokemonName) => `<span class="battle-log-pokemonname" style="color:#63ff78">${LastPokemonName}</span> è stato sostituito da <span 	class="battle-log-pokemonname" style="color:#63ff78">${CurrentPokemonName}</span>.`,

battleDisallowSwitching: (trainerName) => `<span class="battle-log-pokemonname" style="color:#63ff78">${trainerName}</span> non può più essere sostituito.`,
battleAllowSwitching: (trainerName) => `<span class="battle-log-pokemonname" style="color:#63ff78">${trainerName}</span> può essere sostituito di nuovo.`,

battleEnemyStartMagnetRise: (pokemonName) => `<span class="battle-log-pokemonname" style="color:#63ff78">${pokemonName}</span> ha iniziato a levitare.`,
battleEnemyEndMagnetRise: (pokemonName) => `<span class="battle-log-pokemonname" style="color:#63ff78">${pokemonName}</span> ha smesso di levitare.`,

battleEnemyStartTaunt: (pokemonName) => `<span class="battle-log-pokemonname" style="color:#63ff78">${pokemonName}</span> è stato provocato.`,
battleEnemyEndTaunt: (pokemonName) => `<span class="battle-log-pokemonname" style="color:#63ff78">${pokemonName}</span> non è più provocato.`,

// field effects
battleRainEnd: `Ha smesso di piovere`,
battleRainStarted: `Ha iniziato a piovere`,
battleHailStarted: `Ha iniziato a grandinare`,
battleHailDamage: 'I Pokémon sono danneggiati dalla grandine.',
battleHailEnd: 'Ha smesso di grandinare.',
battleSandstormStarted: "Si scatena una tempesta di sabbia",
battleSandstormDamage: "I Pokémon sono danneggiati dalla tempesta di sabbia.",
battleSandstormEnd: "La tempesta di sabbia si placa.",
battleSunStarted: `La luce solare diventa più intensa.`,
battleSunEnd: `La luce solare è tornata alla normalità.`,

// user field effect
battleMistStarted: "I tuoi Pokémon sono avvolti in un manto di nebbia",
battleMistPrevented: "La nebbia impedisce la riduzione delle statistiche.",
battleMistEnd: "La nebbia si è dissipata.",
battleLightScreenStarted: "Uno schermo di luce protegge la squadra dell'utente.",
battleLightScreenEnd: "Lo schermo di luce è scomparso.",
battleReflectStarted: "La squadra dell'utente è protetta da riflessione.",
battleTailwindStarted: "Il vento inizia a soffiare alle spalle della squadra dell'utente.",
battleTailwindEnd: "Il vento smette di soffiare.",
battleReflectEnd: "L'effetto di riflessione è terminato.",
battleTrickRoomStarted: "Le dimensioni sono state distorte.",
battleTrickRoomEnd: "Le dimensioni sono tornate alla normalità.",
battleHazeUsed: "Le modifiche alle statistiche sono state resettate.",

// battle ended
BattleWin: "Congratulazioni, hai vinto la battaglia!",
BattleLose: "Hai perso la battaglia!",
BattleXP: (XP) => `La tua squadra ha guadagnato ${XP} EXP!`,
BattleNoXP: "La tua squadra non ha guadagnato EXP!",

struggle: "Sforzo",

battleDoesntExist: "La battaglia non esiste!",
enterSpectateKey: "Chiave per assistere:",

tooManyConcurrentBattles: "Ci sono troppe battaglie in corso! Per favore riprova tra 5 minuti!"